+++++++++++++++++++++++++++++++++
+-------------------------------+
+------+-----------------+------+
+-------+---------------+-------+
+#-------+-------------+-------#+
+##------+-------------+------##+
+##------+-------------+------##+
+##------+------+------+------##+
+##------+-------------+------##+
+##++++--+++++++D+++++++--++++##+
+##---------------------------##+
+#-----------------------------#+
+-------------------------------+
+-------++++++++-++++++++-------+
+------+-----------------+------+
+------+-------###-------+------+
+------+-----------------+------+
+###---+-----t------c----+---###+
+##+++++++++++++-+++++++++++++##+
+#+-------------1-------------+#+
+++++++++++++++++++++++++++++++++