###############
#1------------#
#-------------#
#-------------#
#--D----------#
#-------------#
###############