#################################
#--------------E----------------#
#------#-----------------#------#
#-------#---------------#-------#
##-------#-------------#-------##
###------#-------------#------###
###------#-------------#------###
###------#------#------#------###
###------#-------------#------###
#######--#######D#######--#######
###---------------------------###
##-----------------------------##
#-------------------------------#
#-------########-########-------#
#------#-----------------#------#
#------#-------###-------#------#
#------#-----------------#------#
####---#-----t------c----#---####
##############-#-#-##############
###----------4-2-1-3----------###
#################################