#################################
#1------------------------------#
#-------------------------------#
#--------#----------------------#
#-------------------#-----------#
#-------------------------------#
#--------#----------------------#
#---------------#---------------#
#-------------------------------#
#-------------------------------#
#-------------------------------#
#################################