+++++++++++++++++++++++++++++++++
+1------------------------------+
+-------------------------------+
+--------+----------------------+
+-------------------+-----------+
+-------------------------------+
+--------+----------------------+
+---------------+---------------+
+-------------------------------+
+-------------------------------+
+-------------------------------+
+++++++++++++++++++++++++++++++++